host	tag	tld
aafp.org	none	org
abcnews.go.com	medical	com
acog.org	medical	org
americanpregnancy.org	medical	org
apps.who.int	none	int
asaptoday.org	none	org
asktmc.com	none	com
atlantichealth.org	medical	org
babies.sutterhealth.org	medical	org
babycenter.ca	medical	ca
babycenter.com	medical	com
babycenter.com	experiences	com
babycenter.com.au	medical	com.au
babycenter.com.my	medical	com.my
babycenter.in	medical	in
babycentre.co.uk	medical	co.uk
bbc.co.uk	medical	co.uk
bellybelly.com.au	medical	com.au
betterhealth.vic.gov.au	medical	vic.gov.au
birth.com.au	medical	com.au
birthbliss.wordpress.com	controversies	com
birthingfromwithin.com	medical	com
birthrites.org	none	org
blog.ican-online.org	medical	org
blog.ican-online.org	controversies	org
blog.northshorelij.com	none	com
blogs.babycenter.com	experiences	com
bodyandhealth.canada.com	medical	com
bodyandsoul.com.au	medical	com.au
breastfeeding.asn.au	medical	asn.au
bupa-intl.com	none	com
bupa.co.uk	medical	co.uk
bupa.com.hk	medical	com.hk
caesarean.org.uk	controversies	org.uk
canaustralia.net	controversies	net
caresinc.org.au	none	org.au
catawbavalleymedical.org	none	org
cdc.gov	medical	gov
celebritybabies.people.com	experiences	com
cesarean.com.au	medical	com.au
childbirthconnection.org	medical	org
chop.edu	medical	edu
chp.edu	none	edu
cmqcc.org	none	org
commonhealth.wbur.org	controversies	org
community.babycenter.com	controversies	com
consensus.nih.gov	medical	gov
content.healthaffairs.org	medical	org
cpanty.com	none	com
cwcare.net	medical	net
dailymail.co.uk	experiences	co.uk
dailymail.co.uk	medical	co.uk
diagnosticimaging.com	none	com
dilile.com	none	com
doctoralia.co.uk	none	co.uk
dogbreedinfo.com	none	com
drjennifermercier.com	medical	com
drkenlaw.com.au	controversies	com.au
dummies.com	medical	com
ehealthme.com	none	com
eheart.com	controversies	com
embryology.med.unsw.edu.au	none	edu.au
emedicinehealth.com	medical	com
essentialbaby.com.au	medical	com.au
foxnews.com	medical	com
friscowomenshealth.com	medical	com
gasexchange.com	medical	com
gfmer.ch	medical	ch
ghc.org	medical	org
gov.uk	controversies	gov.uk
health.howstuffworks.com	medical	com
health.sa.gov.au	none	sa.gov.au
healthcaremagic.com	medical	com
healthcentral.com	medical	com
healthgrades.com	medical	com
healthlinkbc.ca	medical	ca
healthopedia.com	medical	com
healthy-pregnancy.com	medical	com
healthychildren.org	medical	org
hemophilia.org	medical	org
heraldsun.com.au	experiences	com.au
homebirthcesarean.com	none	com
hopkinsmedicine.org	medical	org
huffingtonpost.com	controversies	com
huffingtonpost.com	medical	com
ican-online.net	experiences	net
ican-online.org	controversies	org
icanseattle.wordpress.com	experiences	com
icid.salisbury.nhs.uk	none	nhs.uk
improvingbirth.org	medical	org
institute.nhs.uk	medical	nhs.uk
irishtimes.com	none	com
itriagehealth.com	medical	com
karger.com	medical	com
kidshealth.org	medical	org
kjrh.com	medical	com
lamag.com	controversies	com
livestrong.com	medical	com
marchofdimes.com	medical	com
mayoclinic.com	medical	com
medhelp.org	experiences	org
medicalnewstoday.com	medical	com
medimanage.com	medical	com
medpagetoday.com	medical	com
medrevise.co.uk	medical	co.uk
meht.nhs.uk	medical	nhs.uk
memorialcare.org	medical	org
merckmanuals.com	none	com
mercy.net	medical	net
midwiferytoday.com	medical	com
minnpost.com	medical	com
moh.gov.sg	medical	gov.sg
momkatsnotes.com	none	com
mothersspace.in	medical	in
mumsnet.com	medical	com
muschealth.com	medical	com
mydoctorgames.com	none	com
mygyno.co.ke	none	co.ke
myhealth.alberta.ca	medical	ca
mylot.com	controversies	com
nct.org.uk	medical	org.uk
netdoctor.co.uk	medical	co.uk
netmums.com	medical	com
news-medical.net	medical	net
newser.com	none	com
nhs.uk	medical	nhs.uk
nice.org.uk	medical	org.uk
nichd.nih.gov	medical	gov
nih.gov	medical	gov
nlm.nih.gov	medical	gov
nursingtimes.net	medical	net
nytimes.com	controversies	com
nytimes.com	medical	com
nzherald.co.nz	medical	co.nz
ohsu.edu	none	edu
omaha.com	medical	com
onlymyhealth.com	none	com
orlive.com	medical	com
pantagraph.com	medical	com
parentables.howstuffworks.com	experiences	com
parenting.com	experiences	com
parentingnation.in	medical	in
parents.com	experiences	com
parents.com	medical	com
parentsconnect.com	medical	com
pathways.nice.org.uk	medical	org.uk
patient.co.uk	medical	co.uk
pennstatehershey.adam.com	medical	com
pih.org	medical	org
pindaraprivate.com.au	medical	com.au
plainview.patch.com	none	com
popout.me	none	me
pregnancy.about.com	medical	com
pregnancy.familyeducation.com	medical	com
pregnancy.ygoy.com	medical	com
programme.exordo.com	none	com
rcm.org.uk	medical	org.uk
resus.me	medical	me
rmh-or.org	none	org
rte.ie	medical	ie
salon.com	experiences	com
samcoultersmith.ie	medical	ie
sciencedaily.com	medical	com
scopeblog.stanford.edu	controversies	edu
shvoong.com	medical	com
slate.com	medical	com
smartbrief.com	none	com
starbelliedsneaths.blogspot.com	experiences	com
startribune.com	medical	com
surgerysquad.com	medical	com
tehrantimes.com	controversies	com
telegraph.co.uk	medical	co.uk
termedia.pl	medical	pl
theaustralian.com.au	medical	com.au
theglobeandmail.com	controversies	com
theglobeandmail.com	medical	com
themisischronicles.com	none	com
thespec.com	medical	com
tommys.org	medical	org
turnto23.com	medical	com
ukmsa.org	medical	org
umm.edu	medical	edu
uptodate.com	medical	com
usnews.com	medical	com
vhi.org	medical	org
voices.yahoo.com	medical	com
webmd.boots.com	medical	com
webmd.com	medical	com
whattoexpect.com	medical	com
who.int	medical	int
wiki.answers.com	medical	com
wikihow.com	medical	com
wired.com	medical	com
wisegeek.com	medical	com
wnd.com	controversies	com
womens-health.org.nz	none	org.nz
womens.memorialhermann.org	medical	org
www1.cgmh.org.tw	medical	org.tw